11111111111111111111
10000000000000000001
10000000000000000001
10000000000000000001
10000000000000000001
10000000000000000001
10000000000000000001
10000000000000000001
10000000000000000001
10000000000111122111
10000000011110000001
10000001111110000000
10001111111110000000
11111111111110000000
11111111111111111111