21 15
2 10
111111111111111111117
100000000000000000017
100000000000000000017
100000000000000000017
100000000000000000017
100000000000000000017
100000000000000000017
100000000000000000017
100000000000000000017
100000000001111221117
100000000111100000018
100000011111100000008
100011111111100000008
111111111111100000008
111111111111111111118