21
16
2 12
111111111111111111117
100000000000000000017
100000000000000000017
100000000000000000017
100000000000000000017
100000000000000000017
100000000000000000017
100000000000000000018
100000000000000000008
100000000000000000008
100000000000000000008
100000000000111111118
100000000000111111117
100000400000111111117
111111100000111111117
777777777777777777777