21
16
6 1
111111111111111111117
111111000000000011117
111111000000000001117
111111000000000000117
111111200000000000017
111111600000000000017
100000000000000500017
100000000000000000017
100003333333333333317
100000000000000000017
100000000000000000018
102000000000000000008
102000000000000000008
102000000000000000008
104000040000400011118
777777777777777777777