21
16
3 2
111111111111111111117
100000000000000000017
100000000000000000017
100000000000000000017
111100100011111000017
111101110111000000017
100000000000000000017
133333333333330000017
100000000000000000017
100000000000000005017
100000000000000000017
100000000000000000117
100060000000000000008
100000000000000000017
100000000000000000017
777777777777777777777